 # # # # # # # # # # # # # # # # # # # # # # # # # # # # # # # # # # # # # # # # # # # # # # # # # # # # # # #
 # # # # # # # # # # # # # # # # # # # # # # # # # # # # # # # # # # # # # # # # # # # # # # # # # # # # # # #
 # #   #                       #                   #                      S                        # S     # #
 # #   #   # # # # # # # # #       # # # # #   #   # # # # #   # # # # # # # # # # # # # # # # #   #   #   # #
 # #   #       #   #           #   #           #               #       #                   #   #   #   #   # #
 # #   # # #   #   #   # # # # # # #   # # # # # # # # # # # # #   # # #   # # # # #   #   #   #   #   #   # #
 # #           #   # t t           #   #           #       #               #           #       #       #   # #
 # # # # # # # #   # # # # # # #   #   #   # # #   #   #   # # #   # # # # #   # # # # # # #   #   # # #   # #
 # #               #               #           #       #       #       #       #       #       #       #   # #
 # #   # #   # # # #   # # # # #   # # # # # # # # # # # # #   # # # # #   # # #   # # #   # # # # #       # #
 # #                   #                       #               #                   #       #           #   # #
 # #   # # # # # # # # #   #   #   #   # # #   #   # #   # # # #   #   # # #   # # #   # # #   # # # # #   # #
 # #               #       #   #   #   #       #   #       #       #           #           #   #       #   # #
 # # # # # # # #   # # #   #   #   #   #   # # #   #   # # #   #   # # # # #   #   # # # # #   #   #   #   # #
 # #   #       #           #   #   #   #           #   #       #   #       #       #   #       #   #       # #
 # #   #   #   # # # # # # #   # # #   # # # # # # #   #   # # #   #   #   #   # # #   #   # # #   # # #   # #
 # #       #               #       #   #                   #   #       #   #               #       #   #   # #
 # #   # # # # # # #   # # # # #   #   #   # # # # # # # # #   # # # # #   # # # # #   #   #   # # #   #   # #
 # #   #               #       #   #   #                   #               #       #   #   #       #   #   # #
 # #   #   # # #   #   #   #   #   #   # # # # # # # # #   # # #   #   # # #   #   # # #   # # #   #   #   # #
 # #       #       #       #           #                           #           #                   #       # #
 # # # # # # # # # # # # # # # # # # # # # # # # # # # # # # # # # # # # # # # # # # # # # # # # # # # # # # #
 # # # # # # # # # # # # # # # # # # # # # # # # # # # # # # # # # # # # # # # # # # # # # # # # # # # # # # #