# # # # # # # # # # #
# S S             S #
# # # # # # # # # # #
# t t t t t t t t t #
# # # # # # # # # # #