 # # # # # # # # # # # # # # # # # # # # # # # # # # # # # # # # # # # # # # # # # # # # # # # # # # # # # # #
 # # # # # # # # # # # # # # # # # # # # # # # # # # # # # # # # # # # # # # # # # # # # # # # # # # # # # # #
 # # S #                       #                   #                      S                        # S     # #
 # #   #   # # # # # # # # #       # # # # #   #   # # # # #   # # # # # # # # # # # # # # # # #   #   #   # #
 # #   #       #   #           #   # t         #               #       #                   #   #   #   #   # #
 # #   # # #   #   #   # # # # # # #   # # # # # # # # # # # # #   # # #   # # # # #   #   #   #   #   #   # #
 # #           #   # t             #   # t         #       #             t #     t     #       #       #   # #
 # # # # # # # #   # # # # # # #   #   #   # # #   #   #   # # #   # # # # #   # # # # # # #   #   # # #   # #
 # #               #               #           #       #       #       #       #     t #       #       #   # #
 # #   # #   # # # #   # # # # #   # # # # # # # # # # # # #   # # # # #   # # #   # # #   # # # # #       # #
 # #         S         #                       # S             #                   #       #           #   # #
 # #   # # # # # # # # #   #   #   #   # # #   #   # #   # # # #   #   # # #   # # #   # # #   # # # # #   # #
 # #               # t     #   #   #   #       #   #       #       #     S     #           #   #       #   # #
 # # # # # # # #   # # #   #   #   #   #   # # #   #   # # #   #   # # # # #   #   # # # # #   #   #   #   # #
 # #   #       #           #   # t #   #           #   #       #   # t     #       # t #       #   #       # #
 # #   #   #   # # # # # # #   # # #   # # # # # # #   #   # # #   #   #   #   # # #   #   # # #   # # #   # #
 # #       #   t           #       #   #     S             # t #       #   #               #       #   #   # #
 # #   # # # # # # #   # # # # #   #   #   # # # # # # # # #   # # # # #   # # # # #   #   #   # # #   #   # #
 # #   #               #       #   #   #                   #               #       #   #   #       #   #   # #
 # #   #   # # #   #   #   #   #   #   # # # # # # # # #   # # #   #   # # #   #   # # #   # # #   #   #   # #
 # # S     #       #       #       S   #             S             #           #                   #     S # #
 # # # # # # # # # # # # # # # # # # # # # # # # # # # # # # # # # # # # # # # # # # # # # # # # # # # # # # #
 # # # # # # # # # # # # # # # # # # # # # # # # # # # # # # # # # # # # # # # # # # # # # # # # # # # # # # #