 # # # # # # # # # # # # # # # # # # # # # # # # # # # # # # # # # # # # # # # # # # # # # # # # # # # # # # #
 # # # # # # # # # # # # # # # # # # # # # # # # # # # # # # # # # # # # # # # # # # # # # # # # # # # # # # #
 # # S #                       #                   #                                               #       # #
 # #   #   # # # # # # # # #       # # # # #   #   # # # # #   # # # # # # # # # # # # # # # # #   #   #   # #
 # #   #       #   #           #   # t         #               #       #                   #   #   #   #   # #
 # #   # # #   #   #   # # # # # # #   # # # # # # # # # # # # #   # # #   # # # # #   #   #   #   #   #   # #
 # # S #       #   # t             #   # t         #       #             t #     t     #       #       #   # #
 # #   # # # # #   # # # # # # #   #   #   # # #   #   #   # # #   # # # # #   # # # # # # #   #   # # #   # #
 # # #             #               #           #       #       #       #       #     t #       #       #   # #
 # #   # #   # # # #   # # # # #   # # # # # # # # # # # # #   # # # # #   # # #   # # #   # # # # #       # #
 # #                   #                       #               #                   #       #           #   # #
 # #   # # # # # # # # #   #   #   #   # # #   #   # #   # # # #   #   # # #   # # #   # # #   # # # # #   # #
 # #               # t     #   #   #   #       #   #       #       #           #           #   #       #   # #
 # # # # # # # #   # # #   #   #   #   #   # # #   #   # # #   #   # # # # #   #   # # # # #   #   #   #   # #
 # #   #       #           #   # t #   #           #   #       #   # t     #       # t #       #   #       # #
 # #   #   #   # # # # # # #   # # #   # # # # # # #   #   # # #   #   #   #   # # #   #   # # #   # # #   # #
 # #       #   t           #       #   #                   # t #       #   #               #       #   #   # #
 # #   # # # # # # #   # # # # #   #   #   # # # # # # # # #   # # # # #   # # # # #   #   #   # # #   #   # #
 # #   #               #       #   #   #                   #               #       #   #   #       #   #   # #
 # #   #   # # #   #   #   #   #   #   # # # # # # # # #   # # #   #   # # #   #   # # #   # # #   #   #   # #
 # #       #       #       #           #                           #           #                   #       # #
 # # # # # # # # # # # # # # # # # # # # # # # # # # # # # # # # # # # # # # # # # # # # # # # # # # # # # # #
 # # # # # # # # # # # # # # # # # # # # # # # # # # # # # # # # # # # # # # # # # # # # # # # # # # # # # # #